internal	oracle
system	manager
system	oracle
sys	change_on_install
SYS	CHANGE_ON_INSTALLorINTERNAL
SYSTEM	MANAGER
OUTLN	OUTLN
SCOTT	TIGER
ADAMS	WOOD
JONES	STEEL
CLARK	CLOTH
BLAKE	PAPER.
HR	HR
OE	OE
SH	SH
DBSNMP	DBSNMP
sysman	oem_temp
aqadm	aqadm
ANONYMOUS	ANONYMOUS
CTXSYS	CTXSYS
DIP	DIP
DMSYS	DMSYS
EXFSYS	EXFSYS
MDDATA	MDDATA
MDSYS	MDSYS
MGMT_VIEW	MGMT_VIEW
OLAPSYS	MANAGER
ORDPLUGINS	ORDPLUGINS
ORDSYS	ORDSYS
WK_TEST	WK_TEXT